# NOTES:
# The # Symbol at the start of a line counts as a Comment. To include in dialog, use a \#
# The . Symbol will cause a pause unless escaped with \. (ex: Mr. Oshiro has a pause, Mr\. Oshiro does not)
# Newlines automatically create a Page Break, unless there is an {n} command on the previous line
# Commands: Anything inside of curly braces {...} is a command and should not be translated.

# Inline Text Commands:
# {~}wavy text{/~}
# {!}impact text{/!}
# {>> x}changes speed at which characters are displayed{>>}
# {# 000000}this text is black{#} (uses HEX color values)
# {+MENU_BEGIN} inserts the dialog from the MENU_BEGIN value (in English, "CLIMB")
# {n} creates a newline, without a page break
# {0.5} creates a 0.5 second pause
# {big}this text is large{/big}

# Gameplay Control Commands (should never change)
# {trigger x} this triggers an in-game event
# {anchor} controls the visual position of the textbox in-game

MODNAME_EXTENDEDVARIANTMODE=	Mode Variante étendu
MODOPTIONS_EXTENDEDVARIANTS_TITLE=	Mode Variante étendu

POSTCARD_EXTENDEDVARIANTS_FORCEENABLED=	Tu entres dans une map qui utilise le {# 9B3FB5}Mode Variante étendu{#}.{n}{n}Pour que cette map fonctionne, les {# 9B3FB5}variantes étendues{#} ont été activées et remises à zéro à leurs valeurs par défaut.

MODOPTIONS_EXTENDEDVARIANTS_HEADING=	Variantes
MODOPTIONS_EXTENDEDVARIANTS_HEADING_DASHING=	Dashes
MODOPTIONS_EXTENDEDVARIANTS_HEADING_JUMPING=	Sauts
MODOPTIONS_EXTENDEDVARIANTS_HEADING_VERTICALSPEED=	Vitesse verticale
MODOPTIONS_EXTENDEDVARIANTS_HEADING_MOVING=	Déplacements
MODOPTIONS_EXTENDEDVARIANTS_HEADING_CHASERS=	Courses-poursuites
MODOPTIONS_EXTENDEDVARIANTS_HEADING_BOSSES=	Boss final
MODOPTIONS_EXTENDEDVARIANTS_HEADING_OSHIRO=	Oshiro
MODOPTIONS_EXTENDEDVARIANTS_HEADING_THEO=	Cristaux Theo
MODOPTIONS_EXTENDEDVARIANTS_HEADING_OTHER=	Modifications de gameplay
MODOPTIONS_EXTENDEDVARIANTS_HEADING_TROLL=	Variantes troll
MODOPTIONS_EXTENDEDVARIANTS_HEADING_EVERYWHERE=	Autres éléments de jeu
MODOPTIONS_EXTENDEDVARIANTS_HEADING_MADELINE=	Modifications visuelles de Madeline
MODOPTIONS_EXTENDEDVARIANTS_HEADING_LEVEL=	Modifications visuelles du niveau
MODOPTIONS_EXTENDEDVARIANTS_HEADING_RANDOMIZER=	Variantes aléatoires

MODOPTIONS_EXTENDEDVARIANTS_SUBMENU_MOVEMENT=	Mouvement
MODOPTIONS_EXTENDEDVARIANTS_SUBMENU_GAMEELEMENTS=	Éléments de jeu
MODOPTIONS_EXTENDEDVARIANTS_SUBMENU_VISUAL=	Modifications visuelles
MODOPTIONS_EXTENDEDVARIANTS_SUBMENU_GAMEPLAYTWEAKS=	Modifications de gameplay

MODOPTIONS_EXTENDEDVARIANTS_OPTIONSOUTOFMODOPTIONSMENU= Menu séparé pour les variantes
MODOPTIONS_EXTENDEDVARIANTS_SUBMENUFOREACHCATEGORY=	Sous-menu par catégorie
MODOPTIONS_EXTENDEDVARIANTS_PAUSEMENU_BUTTON=	Variantes étendues
MODOPTIONS_EXTENDEDVARIANTS_MODOPTIONS_BUTTON=	Options des variantes étendues

MODOPTIONS_EXTENDEDVARIANTS_MASTERSWITCH=	Activé
MODOPTIONS_EXTENDEDVARIANTS_GRAVITY=	Gravité
MODOPTIONS_EXTENDEDVARIANTS_FALLSPEED=	Vitesse max. de chute
MODOPTIONS_EXTENDEDVARIANTS_JUMPHEIGHT=	Hauteur des sauts
MODOPTIONS_EXTENDEDVARIANTS_SPEEDX=	Vitesse horizontale
MODOPTIONS_EXTENDEDVARIANTS_STAMINA=	Endurance (110 par défaut)
MODOPTIONS_EXTENDEDVARIANTS_DASHSPEED=	Vitesse du dash
MODOPTIONS_EXTENDEDVARIANTS_LEGACYDASHSPEEDBEHAVIOR=	Ancien comportement pour "Vitesse du dash"
MODOPTIONS_EXTENDEDVARIANTS_LEGACYDASHSPEEDBEHAVIOR_HINT=	Utilisé pour les TAS "teleport mode", laisser désactivé dans les autres cas
MODOPTIONS_EXTENDEDVARIANTS_DASHCOUNT=	Nombre de dashes
MODOPTIONS_EXTENDEDVARIANTS_DISABLEDASHCOOLDOWN=	Pas de pause entre 2 dashes successifs
MODOPTIONS_EXTENDEDVARIANTS_FRICTION=	Friction au sol
MODOPTIONS_EXTENDEDVARIANTS_AIRFRICTION=	Friction en l'air
MODOPTIONS_EXTENDEDVARIANTS_DEFAULT=	Par défaut
MODOPTIONS_EXTENDEDVARIANTS_DISABLEWALLJUMPING=	Désactiver les sauts muraux
MODOPTIONS_EXTENDEDVARIANTS_DISABLECLIMBJUMPING=	Désactiver les sauts en escaladant
MODOPTIONS_EXTENDEDVARIANTS_DISABLEJUMPINGOUTOFWATER=	Désactiver les sauts sur l'eau
MODOPTIONS_EXTENDEDVARIANTS_JUMPCOUNT=	Nombre de sauts
MODOPTIONS_EXTENDEDVARIANTS_INFINITE=	Infini
MODOPTIONS_EXTENDEDVARIANTS_RESETTODEFAULT_EXTENDED=	Remettre les variantes étendues par défaut
MODOPTIONS_EXTENDEDVARIANTS_RESETTODEFAULT_VANILLA=	Remettre les variantes de base par défaut
MODOPTIONS_EXTENDEDVARIANTS_UPSIDEDOWN=	Affichage à l'envers
MODOPTIONS_EXTENDEDVARIANTS_HYPERDASHSPEED=	Vitesse des hyperdashes
MODOPTIONS_EXTENDEDVARIANTS_WALLBOUNCINGSPEED=	Vitesse des super-sauts muraux
MODOPTIONS_EXTENDEDVARIANTS_WALLSLIDINGSPEED=	Vitesse de glissade sur les murs
MODOPTIONS_EXTENDEDVARIANTS_DASHLENGTH=	Durée du dash
MODOPTIONS_EXTENDEDVARIANTS_FORCEDUCKONGROUND=	Toujours se baisser au sol
MODOPTIONS_EXTENDEDVARIANTS_INVERTDASHES=	Inverser les dashes
MODOPTIONS_EXTENDEDVARIANTS_INVERTGRAB=	Inverser la touche Attraper
MODOPTIONS_EXTENDEDVARIANTS_DISABLENEUTRALJUMPING=	Interdire les "neutral jumps"
MODOPTIONS_EXTENDEDVARIANTS_CHANGEVARIANTSRANDOMLY=	Changer les variantes aléatoirement
MODOPTIONS_EXTENDEDVARIANTS_OFF=	Désactivé
MODOPTIONS_EXTENDEDVARIANTS_VANILLA=	De base
MODOPTIONS_EXTENDEDVARIANTS_EXTENDED=	Étendues
MODOPTIONS_EXTENDEDVARIANTS_BOTH=	Les deux
MODOPTIONS_EXTENDEDVARIANTS_CHANGEVARIANTSINTERVAL=	Modifier les variantes...
MODOPTIONS_EXTENDEDVARIANTS_ONSCREENTRANSITION=	Sur chaque écran
MODOPTIONS_EXTENDEDVARIANTS_EVERY=	Toutes les
MODOPTIONS_EXTENDEDVARIANTS_BADELINECHASERSEVERYWHERE=	Course-poursuite avec Badeline partout
MODOPTIONS_EXTENDEDVARIANTS_CHASERCOUNT=	Nombre de poursuivants
MODOPTIONS_EXTENDEDVARIANTS_AFFECTEXISTINGCHASERS=	Modifier les courses-poursuites existantes
MODOPTIONS_EXTENDEDVARIANTS_REGULARHICCUPS=	Hoquet toutes les...
MODOPTIONS_EXTENDEDVARIANTS_HICCUPSTRENGTH=	Force du hoquet
MODOPTIONS_EXTENDEDVARIANTS_DISABLED=	Désactivé
MODOPTIONS_EXTENDEDVARIANTS_REFILLJUMPSONDASHREFILL=	Rendre les sauts en même temps que le dash
MODOPTIONS_EXTENDEDVARIANTS_ROOMLIGHTING=	Eclairage du niveau
MODOPTIONS_EXTENDEDVARIANTS_ROOMBLOOM=	Brillance du niveau
MODOPTIONS_EXTENDEDVARIANTS_GLITCHEFFECT=	Effet "glitch"
MODOPTIONS_EXTENDEDVARIANTS_ANXIETYEFFECT=	Effet d'anxiété
MODOPTIONS_EXTENDEDVARIANTS_BLURLEVEL=	Effet de flou
MODOPTIONS_EXTENDEDVARIANTS_BACKGROUNDBLURLEVEL=	Effet de flou de l'arrière-plan
MODOPTIONS_EXTENDEDVARIANTS_ZOOMLEVEL=	Niveau de zoom
MODOPTIONS_EXTENDEDVARIANTS_OSHIROEVERYWHERE=	Oshiro partout
MODOPTIONS_EXTENDEDVARIANTS_OSHIROCOUNT=	Nombre d'Oshiro
MODOPTIONS_EXTENDEDVARIANTS_REVERSEOSHIROCOUNT=	Nombre d'Oshiro inversés
MODOPTIONS_EXTENDEDVARIANTS_DISABLEOSHIROSLOWDOWN=	Désactiver le ralentissement par Oshiro
MODOPTIONS_EXTENDEDVARIANTS_WINDEVERYWHERE=	Vent partout
MODOPTIONS_EXTENDEDVARIANTS_WINDEVERYWHERE_LEFT=	Gauche
MODOPTIONS_EXTENDEDVARIANTS_WINDEVERYWHERE_RIGHT=	Droite
MODOPTIONS_EXTENDEDVARIANTS_WINDEVERYWHERE_LEFTSTRONG=	Gauche puissant
MODOPTIONS_EXTENDEDVARIANTS_WINDEVERYWHERE_RIGHTSTRONG=	Droite puissant
MODOPTIONS_EXTENDEDVARIANTS_WINDEVERYWHERE_LEFTONOFF=	Gauche intermittent
MODOPTIONS_EXTENDEDVARIANTS_WINDEVERYWHERE_RIGHTONOFF=	Droite intermittent
MODOPTIONS_EXTENDEDVARIANTS_WINDEVERYWHERE_LEFTONOFFFAST=	Gauche int. rapide
MODOPTIONS_EXTENDEDVARIANTS_WINDEVERYWHERE_RIGHTONOFFFAST=	Droite int. rapide
MODOPTIONS_EXTENDEDVARIANTS_WINDEVERYWHERE_ALTERNATING=	Alternant
MODOPTIONS_EXTENDEDVARIANTS_WINDEVERYWHERE_DOWN=	Bas
MODOPTIONS_EXTENDEDVARIANTS_WINDEVERYWHERE_UP=	Haut
MODOPTIONS_EXTENDEDVARIANTS_WINDEVERYWHERE_RIGHTCRAZY=	Droite très puissant
MODOPTIONS_EXTENDEDVARIANTS_WINDEVERYWHERE_RANDOM=	Aléatoire
MODOPTIONS_EXTENDEDVARIANTS_SNOWBALLSEVERYWHERE=	Boules de neige partout
MODOPTIONS_EXTENDEDVARIANTS_SNOWBALLDELAY=	Délai des boules de neige (0.8s par défaut)
MODOPTIONS_EXTENDEDVARIANTS_ADDSEEKERS=	Ajouter des "seekers"
MODOPTIONS_EXTENDEDVARIANTS_DISABLESEEKERSLOWDOWN=	Désactiver le ralentissement par les "seekers"
MODOPTIONS_EXTENDEDVARIANTS_BADELINELAG=	Délai entre Badeline et le joueur
MODOPTIONS_EXTENDEDVARIANTS_DELAYBETWEENBADELINES=	Délai entre deux Badeline (0.4s par défaut)
MODOPTIONS_EXTENDEDVARIANTS_HELDDASH=	Dash maintenu
MODOPTIONS_EXTENDEDVARIANTS_ALLSTRAWBERRIESAREGOLDENS=	Toutes les fraises sont dorées
MODOPTIONS_EXTENDEDVARIANTS_DONTREFILLDASHONGROUND= Ne pas recharger le dash au sol
MODOPTIONS_EXTENDEDVARIANTS_GAMESPEED=	Vitesse de jeu
MODOPTIONS_EXTENDEDVARIANTS_EVERYTHINGISUNDERWATER=	Tous les niveaux sont sous l'eau
MODOPTIONS_EXTENDEDVARIANTS_SUPERDASHSTEERINGSPEED=	Variante Super Sprint - Vitesse de rotation

MODOPTIONS_EXTENDEDVARIANTS_DONTREFILLSTAMINAONGROUND=	Ne pas recharger l'endurance au sol

MODOPTIONS_EXTENDEDVARIANTS_THEOCRYSTALSEVERYWHERE= Cristaux Theo partout
MODOPTIONS_EXTENDEDVARIANTS_AllowThrowingTheoOffscreen=	Lancer Theo hors de l'écran
MODOPTIONS_EXTENDEDVARIANTS_AllowThrowingTheoOffscreen_desc1=
	Oui = Tu es obligé d'aller dans la pièce où Theo est tombé
MODOPTIONS_EXTENDEDVARIANTS_AllowThrowingTheoOffscreen_desc2=
	Non = Theo rebondit sur les bords de l'écran et tu dois le porter pour passer
MODOPTIONS_EXTENDEDVARIANTS_AllowLeavingTheoBehind=	Permettre d'abandonner Theo

MODOPTIONS_EXTENDEDVARIANTS_BADELINEBOSSESEVERYWHERE=	Boss final (Badeline) partout
MODOPTIONS_EXTENDEDVARIANTS_BADELINEATTACKPATTERN=	Pattern d'attaque du boss
MODOPTIONS_EXTENDEDVARIANTS_CHANGEPATTERNSOFEXISTINGBOSSES=	Modifier le pattern des boss existants
MODOPTIONS_EXTENDEDVARIANTS_FIRSTBADELINESPAWNRANDOM=	Position du premier boss
MODOPTIONS_EXTENDEDVARIANTS_FIRSTBADELINESPAWNRANDOM_OFF=	Opposé de la salle
MODOPTIONS_EXTENDEDVARIANTS_FIRSTBADELINESPAWNRANDOM_ON=	Aléatoire
MODOPTIONS_EXTENDEDVARIANTS_BADELINEBOSSCOUNT=	Nombre de boss
MODOPTIONS_EXTENDEDVARIANTS_BADELINEBOSSNODECOUNT=	Nombre de positions pour chaque boss
MODOPTIONS_EXTENDEDVARIANTS_BADELINEPATTERN_1=	Tirs lents
MODOPTIONS_EXTENDEDVARIANTS_BADELINEPATTERN_2=	Laser > Tir
MODOPTIONS_EXTENDEDVARIANTS_BADELINEPATTERN_3=	Double-tirs rapides
MODOPTIONS_EXTENDEDVARIANTS_BADELINEPATTERN_4=	Double-tirs > Laser
MODOPTIONS_EXTENDEDVARIANTS_BADELINEPATTERN_5=	Laser > Double-tirs
MODOPTIONS_EXTENDEDVARIANTS_BADELINEPATTERN_9=	Double-tirs lents
MODOPTIONS_EXTENDEDVARIANTS_BADELINEPATTERN_10=	Rien
MODOPTIONS_EXTENDEDVARIANTS_BADELINEPATTERN_14=	Laser rapide
MODOPTIONS_EXTENDEDVARIANTS_BADELINEPATTERN_15=	Laser lent

MODOPTIONS_EXTENDEDVARIANTS_COLORGRADING=	Coloration du niveau
MODOPTIONS_EXTENDEDVARIANTS_CG_NONE=	Aucune
MODOPTIONS_EXTENDEDVARIANTS_CG_COLD=	Froid
MODOPTIONS_EXTENDEDVARIANTS_CG_HOT=	Chaud
MODOPTIONS_EXTENDEDVARIANTS_CG_CREDITS=	Crédits
MODOPTIONS_EXTENDEDVARIANTS_CG_FEELINGDOWN=	Se sent mal
MODOPTIONS_EXTENDEDVARIANTS_CG_GOLDEN=	Doré
MODOPTIONS_EXTENDEDVARIANTS_CG_OLDSITE=	Site ancien
MODOPTIONS_EXTENDEDVARIANTS_CG_PANICATTACK=	Crise de panique
MODOPTIONS_EXTENDEDVARIANTS_CG_REFLECTION=	Réflexion
MODOPTIONS_EXTENDEDVARIANTS_CG_TEMPLEVOID=	Temple (vide)
MODOPTIONS_EXTENDEDVARIANTS_CG_TETRIS=	Tetris (Celsius)
MODOPTIONS_EXTENDEDVARIANTS_CG_INVERTED=	Couleurs inversées
MODOPTIONS_EXTENDEDVARIANTS_CG_GREYSCALE=	Noir et blanc
MODOPTIONS_EXTENDEDVARIANTS_CG_SEPIA=	Sépia
MODOPTIONS_EXTENDEDVARIANTS_CG_RGBSHIFT1=	Recoloration (1)
MODOPTIONS_EXTENDEDVARIANTS_CG_RGBSHIFT2=	Recoloration (2)
MODOPTIONS_EXTENDEDVARIANTS_CG_HOLLYS_RANDOMNOISE=	Corrompue
MODOPTIONS_EXTENDEDVARIANTS_CG_TRIGGER=	Définie par la map

MODOPTIONS_EXTENDEDVARIANTS_JELLYFISHEVERYWHERE=	Méduses partout
MODOPTIONS_EXTENDEDVARIANTS_RISINGLAVAEVERYWHERE=	Lave / Glace partout
MODOPTIONS_EXTENDEDVARIANTS_RISINGLAVASPEED=	Vitesse de la lave / glace

MODOPTIONS_EXTENDEDVARIANTS_EXPLODELAUNCHSPEED=	Vitesse donnée par les explosions
MODOPTIONS_EXTENDEDVARIANTS_DISABLESUPERBOOSTS=	Désactiver les super-boosts
MODOPTIONS_EXTENDEDVARIANTS_DISABLESUPERBOOSTS_NOTE=	(boost donné lorsque tu appuies dans la direction dans laquelle tu es propulsé)

MODOPTIONS_EXTENDEDVARIANTS_INVERTHORIZONTALCONTROLS=	Inverser les contrôles horizontaux
MODOPTIONS_EXTENDEDVARIANTS_INVERTVERTICALCONTROLS=	Inverser les contrôles verticaux

MODOPTIONS_EXTENDEDVARIANTS_BOUNCEEVERYWHERE=	Rebondir partout
MODOPTIONS_EXTENDEDVARIANTS_SCREENSHAKEINTENSITY=	Intensité des tremblements (:extendedvariants_warning:EPILEPSIE)

MODOPTIONS_EXTENDEDVARIANTS_JUNGLESPIDERSEVERYWHERE= Araignées de la jungle partout
MODOPTIONS_EXTENDEDVARIANTS_JUNGLESPIDERSEVERYWHERE_DISABLED=	Désactivé
MODOPTIONS_EXTENDEDVARIANTS_JUNGLESPIDERSEVERYWHERE_BLUE=		Bleues
MODOPTIONS_EXTENDEDVARIANTS_JUNGLESPIDERSEVERYWHERE_PURPLE=		Violettes
MODOPTIONS_EXTENDEDVARIANTS_JUNGLESPIDERSEVERYWHERE_RED=		Rouges

MODOPTIONS_EXTENDEDVARIANTS_DASHDIRECTION=	Direction des dashes
MODOPTIONS_EXTENDEDVARIANTS_DASHDIRECTION_0=	Toutes directions
MODOPTIONS_EXTENDEDVARIANTS_DASHDIRECTION_1=	Pas de diagonaux
MODOPTIONS_EXTENDEDVARIANTS_DASHDIRECTION_2=	Diagonaux uniquement
MODOPTIONS_EXTENDEDVARIANTS_DASHDIRECTION_3=	Personnalisé
MODOPTIONS_EXTENDEDVARIANTS_DASHDIRECTION_ALLOWED=	Directions autorisées pour le dash
MODOPTIONS_EXTENDEDVARIANTS_DASHDIRECTION_TOPLEFT=	En haut à gauche
MODOPTIONS_EXTENDEDVARIANTS_DASHDIRECTION_TOP=	En haut
MODOPTIONS_EXTENDEDVARIANTS_DASHDIRECTION_TOPRIGHT=	En haut à droite
MODOPTIONS_EXTENDEDVARIANTS_DASHDIRECTION_RIGHT=	A droite
MODOPTIONS_EXTENDEDVARIANTS_DASHDIRECTION_BOTTOMRIGHT=	En bas à droite
MODOPTIONS_EXTENDEDVARIANTS_DASHDIRECTION_BOTTOM=	En bas
MODOPTIONS_EXTENDEDVARIANTS_DASHDIRECTION_BOTTOMLEFT=	En bas à gauche
MODOPTIONS_EXTENDEDVARIANTS_DASHDIRECTION_LEFT=	A gauche

MODOPTIONS_EXTENDEDVARIANTS_BACKGROUNDBRIGHTNESS=	Luminosité de l'arrière-plan

MODOPTIONS_EXTENDEDVARIANTS_DISABLEMADELINESPOTLIGHT=	Désactiver la lumière de Madeline

MODOPTIONS_EXTENDEDVARIANTS_DISABLEKEYSSPOTLIGHT=	Désactiver la lumière des clés

MODOPTIONS_EXTENDEDVARIANTS_FOREGROUNDEFFECTOPACITY=	Opacité des effets au premier plan

MODOPTIONS_EXTENDEDVARIANTS_MADELINEISSILHOUETTE=	Madeline est une silhouette
MODOPTIONS_EXTENDEDVARIANTS_DASHTRAILALLTHETIME=	Effet "dash" tout le temps
MODOPTIONS_EXTENDEDVARIANTS_MADELINEHASPONYTAIL=	Madeline a une queue de cheval

MODOPTIONS_EXTENDEDVARIANTS_DISABLECLIMBINGUPORDOWN=	Empêcher de grimper vers le haut ou le bas

MODOPTIONS_EXTENDEDVARIANTS_MADELINEBACKPACKMODE= Sac à dos de Madeline
MODOPTIONS_EXTENDEDVARIANTS_MADELINEBACKPACKMODE_DEFAULT= Par défaut
MODOPTIONS_EXTENDEDVARIANTS_MADELINEBACKPACKMODE_BACKPACK= Avec sac à dos
MODOPTIONS_EXTENDEDVARIANTS_MADELINEBACKPACKMODE_NOBACKPACK= Sans sac à dos

MODOPTIONS_EXTENDEDVARIANTS_SWIMMINGSPEED=	Vitesse de nage

MODOPTIONS_EXTENDEDVARIANTS_BOOSTMULTIPLIER=	Multiplicateur de boost

MODOPTIONS_EXTENDEDVARIANTS_FRIENDLYBADELINEFOLLOWER=	Badeline suit le joueur

MODOPTIONS_EXTENDEDVARIANTS_DISABLEREFILLSONSCREENTRANSITION=	Ne pas donner de dash au changement d'écran
MODOPTIONS_EXTENDEDVARIANTS_RESTOREDASHESONRESPAWN=	Restaurer le nombre de dashes après une mort
MODOPTIONS_EXTENDEDVARIANTS_RESTOREDASHESONRESPAWN_NOTE=	Si tu avais 1 dash au dernier point de contrôle, tu réapparaîtras avec 1 dash

MODOPTIONS_EXTENDEDVARIANTS_AutomaticallyResetVariants= Remettre à zéro les variantes automatiquement
MODOPTIONS_EXTENDEDVARIANTS_AutomaticallyResetVariants_description= lorsque tu entres dans un niveau utilisant des variantes étendues

MODOPTIONS_EXTENDEDVARIANTS_DISPLAYDASHCOUNT=	Afficher le nombre de dashes

MODOPTIONS_EXTENDEDVARIANTS_EVERYJUMPISULTRA=	Faire un "ultra" à chaque saut
MODOPTIONS_EXTENDEDVARIANTS_EVERYJUMPISULTRA_DESC=	Madeline s'accroupit et a un boost de vitesse horizontale de 1.2x

MODOPTIONS_EXTENDEDVARIANTS_COYOTETIME=	"Coyote time"
MODOPTIONS_EXTENDEDVARIANTS_COYOTETIME_DESC=	Temps pendant lequel tu peux sauter après avoir quitté une plateforme

MODOPTIONS_EXTENDEDVARIANTS_NOFREEZEFRAMES=	Désactiver les "freeze frames"
MODOPTIONS_EXTENDEDVARIANTS_NOFREEZEFRAMES_DESC=	Ne pas geler le jeu pendant quelques instants au dash, etc.

MODOPTIONS_EXTENDEDVARIANTS_PRESERVEEXTRADASHESUNDERWATER=	Conserver les dash supplémentaires dans l'eau

MODOPTIONS_EXTENDEDVARIANTS_ALWAYSINVISIBLE= Madeline est toujours invisible

MODOPTIONS_EXTENDEDVARIANTS_DISPLAYSPEEDOMETER= Afficher un compteur de vitesse
MODOPTIONS_EXTENDEDVARIANTS_DISPLAYSPEEDOMETER_DISABLED= Désactivé
MODOPTIONS_EXTENDEDVARIANTS_DISPLAYSPEEDOMETER_HORIZONTAL= Horizontale
MODOPTIONS_EXTENDEDVARIANTS_DISPLAYSPEEDOMETER_VERTICAL= Verticale
MODOPTIONS_EXTENDEDVARIANTS_DISPLAYSPEEDOMETER_BOTH= Les deux

MODOPTIONS_EXTENDEDVARIANTS_RANDOMIZER=	Options des variantes aléatoires
MODOPTIONS_EXTENDEDVARIANTS_RANDOMIZERTITLE=	VARIANTES ALÉATOIRES
MODOPTIONS_EXTENDEDVARIANTS_RANDOMIZER_ENABLED_VANILLA=	Choisir les variantes de base à modifier
MODOPTIONS_EXTENDEDVARIANTS_RANDOMIZER_ENABLED_EXTENDED=	Choisir les variantes étendues à modifier
MODOPTIONS_EXTENDEDVARIANTS_RANDOMIZER_GENERALSETTINGS=	Réglages généraux
MODOPTIONS_EXTENDEDVARIANTS_RANDOMIZER_VARIANTSET=	Variantes à modifier
MODOPTIONS_EXTENDEDVARIANTS_RANDOMIZER_REROLLMODE=	Mode "reroll"
MODOPTIONS_EXTENDEDVARIANTS_RANDOMIZER_MAXENABLEDVARIANTS=	Nombre de variantes max à activer
MODOPTIONS_EXTENDEDVARIANTS_RANDOMIZER_MAXENABLEDVARIANTS_REROLL=	Variantes à activer à chaque "reroll"
MODOPTIONS_EXTENDEDVARIANTS_RANDOMIZER_VANILLAFY=	Désactiver des variantes si bloqué pendant...
MODOPTIONS_EXTENDEDVARIANTS_RANDOMIZER_DISPLAYONSCREEN=	Afficher les variantes actives à l'écran
MODOPTIONS_EXTENDEDVARIANTS_RANDOMIZER_SETSEED=	Définir la graine
MODOPTIONS_EXTENDEDVARIANTS_RANDOMIZER_SEEDINPUT= Graine :
MODOPTIONS_EXTENDEDVARIANTS_RANDOMIZER_SEEDDESCRIPTION1= Si tu pars de la même salle avec la même graine,
MODOPTIONS_EXTENDEDVARIANTS_RANDOMIZER_SEEDDESCRIPTION2= les mêmes variantes seront tirées